%%%%%%%%%%%%%%%%%%%%%%%%%
%.. P  ....      ....   %
%..  ...  ...  ...  ... %
%..  ...  ...  ...  ... %
%..    ....      .... G %
%..  ...  ...  ...  ... %
%..  ...  ...  ...  ... %
%..    ....      ....   %
%%%%%%%%%%%%%%%%%%%%%%%%%