%%%%%%%%%%%%%%%%%%%%
%.......%  G%......%
% %%...      ...%% %
% %..............% %
% %%...%%%%%%...%% %
%........P.........%
%%%%%%%%%%%%%%%%%%%%